NO ./maps/texture/minecraft.xpm
SO ./maps/texture/minecraft.xpm
WE ./maps/texture/minecraft.xpm
EA ./maps/texture/minecraft.xpm

C 135,206,235
F 91,135,49

1111011111111111111      
1000000000101101011      
1000000000001101011      
1000E00001011011111      
1000000000001101011      
1000000000101101011111111
1000000000101101011100001
1000000000101101011100111
1000000000000000000000001
1000000000101101011111111
1000000000101101011      
1000000000101101011      
1111111111111111111      