NO ./maps/texture/minecraft.xpm
SO ./maps/texture/minecraft.xpm
WE ./maps/texture/minecraft.xpm
EA ./maps/texture/minecraft.xpm

C 135,206,235
F 91,135,49

111111111111111111111111111111
100001000000000000000000000001
100001000000000000000000000001
100001000000000000000000000001
100011000000000000000000000001
100000000000111100000000000001
1000000000001  100000000000001
1000000000001  100000000000001
1000000000001  100000000000001
100000000000111100000000000001
100000000000000000000000000001
100000000000000000000000000001
100000000000010001000000000001
100000000000011111000000000001
100000000000011000000000000001
111111111111111111111111111111