NO ./maps/texture/minecraft.xpm
SO ./maps/texture/minecraft.xpm
WE ./maps/texture/minecraft.xpm
EA ./maps/texture/minecraft.xpm

C 135,206,235
F 91,135,49

111111111111111111111111111111                              
100000000000000000000000000001                              
100000000000000000000000000001                              
100000000000000000000000N00001                              
111111111111100000000000000001                              
            100000000000000001111111111111                  
            100000000000000000000000000001                  
            100000000000000000000000000001                  
            100000000000000001111111111111                  
111111111111100000000000000001                              
100000000000000000000000000001111111111111111111111111111111
100000000000000000000000000000000000000000000000000000000001
100000000000010001000000000000000000000000000000000000000001
100000000000011111000000000000000000000000000000000000000001
100000000000011000000000000001111111111111111111111111111111
111111111111111111111111111111                              