NO                  ./maps/texture/nord.xpm
SO ./maps/texture/sud.xpm
WE ./maps/texture/ovest.xpm
EA ./maps/texture/est.xpm





C       135,206,235
F      133,94,66



    1111111111111111111111
111110000000001101011      
111100000101101111111    
1000000000001101011      
10000N0000101101011111111
1000000000101101011100001
1000000000101101011100111
1000000000000000000000001
11111100000101101011111111          
1000000000101101011111    
111111111000010110101   
    111111111111111111111   
