NO ./assets/images/wall_1.xpm
SO ./assets/images/wall_2.xpm
WE ./assets/images/wall_3.xpm
EA ./assets/images/wall_4.xpm
F 184,113,39
C 51,198,227

        1111111111111111111111111
       11000001000110000000000001
        1011000001110000000000001
        1001000000D00000000001111
111111  101100011111D1111111111 
1111011 11111101 100000010001    
11110111111111D1 101010010001
11000000110101011100000010001
100000000000000000000000D0001
10000000000000000000000000001
1000N000000000000000010000001
10000000000000000000000000001
10000000000000000000000000001
11000001110101011111011110001
11110111 1110101 101111010001
11111111 1111111 111111111111
