NO ./assets/images/north.xpm
SO ./assets/images/wall.xpm
WE ./assets/images/wall.xpm
EA ./assets/images/wall.xpm
F 184,113,39
C 51,198,227

1111111111111111111111111
1100000100011000000000001
1011000001110000000000001
1001000000D0000N000001111
1111111111111111111111111

