NO ./assets/images/north.xpm
SO ./assets/images/wall.xpm
WE ./assets/images/wall.xpm
EA ./assets/images/wall.xpm
F 184,113,39
C 51,198,227

111111111111
100000000011
100000000011
100000000011
100000000011
10000N000011
100000000011
100000000011
100000000011
100000000011
111111111111

