NO ./assets/images/wall_1.xpm
SO ./assets/images/wall_2.xpm
WE ./assets/images/wall_3.xpm
EA ./assets/images/wall_4.xpm
F 184,113,39
C 51,198,227

1111111111111111111111111111111
1000000000011000000000000000001
1011000000111000000000000000001
1011000000000000000000000000001
1011000000111000000000000000001
1000000000000111000001110111001
1111011111111111101110000000001
1111011111111111101110000000001
1100000000110101111010100110001
1000000000000000110001000000001
1000000000000000110101000000001
1100000011000100000000000000001
1111011111111000000000000000001
1000000000000011000000010000001
1000000000000000000000010100001
10000S0000010000000100000000101
1000000000000000111010001000001
1000000000000000011000010000001
1111111111111111111111111111111

