NO ./maps/texture/no.xpm               
SO ./maps/texture/so.xpm
EA ./maps/texture/ea.xpm
WE ./maps/texture/e.xpm
C    1,2,3
F   4, 5, 8

1111111
1111111